GGGGGGGMGMGMGMGGGGGAAAAGGGGGGGGMGMMMMMGGGG
MGMMMMGGGGGMGMGMMMMAAAAGGMMMMGGMGGGGGMGMMM
GGGGGGGMMMMMGMGGGGAAAAAAGGGGMGGMGMMMGMGMMM
GMMMMGGMGGGGGGGGAAAAAAAAAAGGMGGMGGGMGGGGGG
GMGGMGGMGMGMMMGAAAAAAAAAAAAGMMGMMMGMMMMGMM
GMGGMGGGGMGGMGGAAAAAAAAAAAAGGGGGGMGGGGMGGG
GMMGMGGMGMGMAAAAAAAAAAAAAAAAAGGMGMMMMGMMMM
GGGGMMMMGMGMAAAAAAAGGGGAAAAAAAGGGGGGGGGGGG
GMGGMGGGGMAAAAAAAAMMMMGGGAAAAAAAGMMMGMMMMM
GMMMMMMGGGAAAAAAGGMGGGGMMGAAAAAAGMGMGMGGGG
GGGMGGGGAAAAAAAAGGMMMMGGGGGGAAAAGMGMGMMGMM
GGMMAAAAAAAAAAAAGGGGGMGMMMGGGAAAGGGGGGGGGG
MMAAAAAAAAAAAAAAAGMMGMGMGGGGGAAAAAGMMMMGMG
AAAAAAGGAAAAAAAAAAGGGMGGGAAAAAAAAAGGGGMGMG
AAAAAAGGAAAAAAAAAAAAGGGGAAAAAAAAAAAAAGMGMG
AAAAAGGMMMGAAAAAAAAAAAAAAAAAAAAGAAAAAGMMMM
AAAMGGGMGMGAAAAAAAAAAAAAAAAAAAMGMAAAAGGGGG
AAGMGMMMGMGAAAAAAAAGAAAAAAAAAAMGMMAAAAGMMG
GGMMGGGMGMMAAAAAAAGGGAAAAAAAAAMGMAAAAAAGMG
MMMGGMMMGGGAAAAAAGGKGGAAAAAAAAAAAAAAAAAGMM
GGGGGMGGAAAAAAAAAAGGGAAAAAAAAAGGGGGAAAAAGG
MMGMMMGAAAAAAAAAAAAGAAAAAAAAAAGMMMMAAAAAAA
GGGGMGGAAAAMMMAAAAAAAAAAAAAMMMMGGMAAAAAAAA
GMMMMGGAAAGGGMAAAAAAAAAAAAAMGGGGGMAAAGGAAA
GMGGGGMAAAAMMMAAAAAAAAAAAAGMGMMMGMMMGGGGAA
GMGGMMMMGAAAAAAAAAAAAAAAAAMMGMGMGGMGMMMGAA
GGGGMGGMGAAAAAAAAMMMAAAAAAGGGMGGGMMGMGMGAA
AGMGMGGGGGGGGAAAGGGGGGAAAAMMGMMMGMGGGGMGAA
AGMGMMMMGGMMGAAAGGMMGGAAAAGMGGGGGGGMMMMGAA
AAAGGGGMGGMGGAAAMGGMMGAAAAGMMMMMGMMGGGAAAA
AAAGMMGGGGGGGAAAAMGGMGAAAAAAMGGGGMGAAAAAAA
AAAAAMGAAAAAAAAAAAAGGGAAAAAAMMMMMMAAAAMMMM
GAAAAMGAAAAAAAAAAAAAGGAAAAAAGGGGGGAAAMMGGG
GGMAAAAAAAAAAAAAAAAAAAAAAAAAAAAAAAAAAMGGMG
GGMAAAAAAAAAAAAAAAAAAAAAAAAAAAAAAAAAAGGGMG
GAAAAGGAAAAAAAAAAGGGGGGGGGAAAAAAAAAAAMMGGG
AAAAAGMAAAAAAAAGGMMMGMMMGGGAAAAAGGGAAAMMMM
AAAAAGGGAAAAAAMGGGGGGMGMGMMAAAAGMGMGAAAAAA
AAAGGGGGAAAAAMMGMGGGGMGMGGGMGAAGMGMGAAAAAA
GGGGMMGMMMGAGMGGMGMMMMGMMMGMGAAGMGMGGGGAAA
AGGGGGGGGMGGGGGGGGMGGGGGGMGMGGGMMGMMGGMGAA
AGMMGGMMGGGGGMGMMGGGMMGMGGGGGMGGGGGGMGGGAA